5;55;55;55;0;0;0;0;0;0;0;0;0;0;3;33;33;33;0;0;0;0;0;0;0;0;0;0;4;44;44;44
55;55;55;55;0;0;0;0;0;0;0;0;0;0;33;33;33;33;0;0;0;0;0;0;0;0;0;0;44;44;44;44
55;55;55;55;0;0;0;0;0;0;0;0;0;0;33;33;33;33;0;0;0;0;0;0;0;0;0;0;44;44;44;44
55;55;55;55;1;1;1;0;0;0;0;0;1;1;33;33;33;33;1;1;0;0;0;0;0;1;1;1;44;44;44;44
0;0;0;1;1;1;1;0;0;0;0;0;1;1;1;1;1;1;1;1;0;0;0;0;0;1;1;1;1;0;0;0
0;0;0;1;1;1;1;0;0;0;0;0;1;1;1;1;1;1;1;1;0;0;0;0;0;1;1;1;1;0;0;0
0;0;0;1;1;1;1;0;0;0;0;0;1;1;1;1;1;1;1;1;0;0;0;0;0;1;1;1;1;0;0;0
0;0;0;0;0;0;0;0;0;0;0;0;0;0;0;0;0;0;0;0;0;0;0;0;0;0;0;0;0;0;0;0
0;0;0;0;0;0;0;0;0;0;0;0;0;0;0;0;0;0;0;0;0;0;0;0;0;0;0;0;0;0;0;0
0;0;0;0;0;0;0;0;0;0;0;0;0;0;0;0;0;0;0;0;0;0;0;0;0;0;0;0;0;0;0;0
0;0;0;0;0;0;0;0;0;0;0;0;0;0;0;0;0;0;0;0;0;0;0;0;0;0;0;0;0;0;0;0
0;0;0;0;0;0;0;0;0;0;0;0;0;0;0;0;0;0;0;0;0;0;0;0;0;0;0;0;0;0;0;0
0;0;0;0;0;0;0;0;0;0;0;0;0;0;0;0;0;0;0;0;0;0;0;0;0;0;0;0;0;0;0;0
0;0;0;0;0;0;0;0;0;0;0;0;0;0;0;0;0;0;0;0;0;0;0;0;0;0;0;0;0;0;0;0
0;0;0;0;0;0;0;0;0;0;0;0;0;0;0;0;0;0;0;0;0;0;0;0;0;0;0;0;0;0;0;0
0;0;0;0;0;0;0;0;0;0;0;0;0;0;0;0;0;0;0;0;0;0;0;0;0;0;0;0;0;0;0;0
0;0;0;0;0;0;0;0;0;0;0;0;0;0;0;2;22;0;0;0;0;0;0;0;0;0;0;0;0;0;0;0
0;0;0;0;0;0;0;0;0;0;0;0;0;0;0;22;22;0;0;0;0;0;0;0;0;0;0;0;0;0;0;0
0;0;0;0;0;0;0;0;0;0;0;0;0;0;0;0;0;0;0;0;0;0;0;0;0;0;0;0;0;0;0;0
